111111111111
100000000001
100000000001
100000000001
100000000001
10000000P001
111110001111
111000000001
111111110001
111111111111
